{
    "arena": [
      "<.......................................>",
      "<.......................................>",
      "<.......................................>",
      "<......R.R.R.R.R.R.R.R.R.R.R.R.R........>",
      "<......R................................>",
      "<......R..............1.................>",
      "<......R.....0..........................>",
      "<......R......0........1................>",
      "<.......................................>",
      "<................0........1....R........>",
      "<...........0..................R........>",
      "<....................0....1....R........>",
      "<..............................R........>",
      "<......R.R.R.R.R.R.R.R.R.R.R.R.R........>",
      "<.............3.........................>",
      "<..........................1............>",
      "<.......................................>",
      "<..........................1............>",
      "<............3..............1...........>",
      "<.......................................>",
      "<.......................................>",
      "<.......................................>",
      "<.....................1.................>",
      "<...........3...........................>",
      "<.......................................>",
      "<.......................................>",
      "<..........3............................>",
      "<......................3................>",
      "<.......................................>",
      "<.......................................>",
      "<.......................................>",
      "<........................4.....4........>",
      "<.......................................>",
      "<............4......4...............4...>",
      "<.......................................>",
      "<........4..............................>",
      "<.......................................>",
      "<.......................................>",
      "<.......................................>",
      "<.......................................>"
    ],
    "enemies": [
      {
        "type": "manager",
        "x": 0,
        "y": 0,
        "difficulty": 10
      }
    ],
    "challenges": [
      {
        "type": "manager",
        "action": "capture",
        "qty": 6
      },
      {
        "type": "gangster",
        "action": "capture",
        "qty": 3
      },
      {
        "type": "chefao",
        "action": "capture",
        "qty": 7
      }
    ],
    "tools": {
      "energy_block": {
        "qty": 30
      }
    }
  }
  